XXXXXXXXXXXXXXXXX
XA   X          X
X    XX    XX   X
X               X
XXXXXXXXXXX XXX X
X           X   X
X           X   X
X     X      X  X
X               X
XXXXXX XXXX XXXXX
X               X
X              SX
X               X
XXXX     XXXXXXXX
X               X
X               X
XXXXXXXXXXXXXXXXX