XXXXXXXXXXXXXXXXX
XA   X          X
X    XX    XX   X
X               X
XXXXXXXXXXX XXX X
X           X   X
X           X   X
X     X      X  X
X               X
XXXXXX XXXXXXXXXX
X               X
X             S X
X               X
XXXX     XXXXXXXX
X               X
X               X
XXXXXXXXXXXXXXXXX
